######.##############.######
#............##............#
#.####.#####.##.#####.####.#
#.#  #.#   #.##.#   #.#  #.#
#.#  #.#   #.##.#   #.#  #.#
#.####.#####.##.#####.####.#
............................
#.####.#####    #####.####.#
#.#  #.##    MMM   ##.#  #.#
#.####.##############.####.#
.............P..............
#.####.#####.##.#####.####.#
#.#  #.#   #.##.#   #.#  #.#
#.#  #.#   #.##.#   #.#  #.#
#.####.#####.##.#####.####.#
#............##............#
######.##############.######
