######.##############.######
#P...........##............#
#.####.#####.##.#####.####.#
#.#  #.#   #.##.#   #.#  #.#
#.####.#   #.##.#   #.#  #.#
#......#####....#   #.####.#
######.#####.##.#####......#
#    #.......##.......####.#
######.#####.##.#####.#  #.#
 ......#   #.##.#   #.#  #. 
######.#   #.##.#####.####.#
#    #.#####.##.#   #.#  #.#
######.#####.##.#####.####.#
#............##............#
######.##############.######