######.##############.######
#P...........##............#
#.####.#####.##.#####.####.#
#.#  #.#   #.##.#   #.#  #.#
#.####.#   #.##.#   #.#  #.#
#......#####....#   #.####.#
######.#####.##.#####......#
#    #.......##.......####.#
######.#####.##.#####.#  #.#
 ......#   #.##.#   #.#  #. 
######M#   #M##.#####.####.#
#    #.#####.##.#   #.#  #.#
######.#####.##.#####.####.#
#............##...........M#
######.##############.######