######.##############.######
#............##............#
#.####.#####.##.#####.####.#
#.#  #.#   #.##.#   #.#  #.#
#.#  #.#   #.##.#   #.#  #.#
#.####.#####.##.#####.####.#
............................
#.####.######  ######.####.#
#.#  #.###       ####.#  #.#
#.####.##############.####.#
.............P..............
#.####.#####.##.#####.####.#
#.#  #.#   #.##.#   #.#  #.#
#.#  #.#   #.##.#   #.#  #.#
#.####.#####.##.#####.####.#
#............##............#
######.##############.######